1111111111111111111111000000000000000000000011111000000000000000
1111111111111111111111000000000000000000001111111110000000000000
1111111111111111111111000000000000000000011111111111100000000000
1111111111111111111111000000000000000000111111111111110000000000
1111111111111111111111100000000000000001111111111111111000000000
1111111111111111111111100000000000000001111111111111111000000000
1111111111111111111111110000000000000011111111111111111100000000
1111111111111111111111111000000000000111111111111111111100000000
1111111111111111111111111110000000001111111111111111111100000000
1111111111111111111111111111100000011111111111111111111100000000
1111111111111111111111111111111000111111111111111111111100000000
1111111111111111111111111111111111111111111111111111111100000000
1111111111111111111111111111111111111111111111111111111100000000
1111111111111111111111111111111111111111111111111111111100000000
1111111111111111111111111111111111111111111111111111111100000000
1111111111111111111111111111111111111111111111111111111000000000
1111111111111100111111111111111111111111111111111111110000000000
0111111111110000001111111111111111111111111111111111110000000000
0111111111000000000011111111111111111111111111111111100000000000
0111111110000000000001111111111111111111111111111110000000000000
0111111110000000000000111111111111111111111111111100000000000000
0111111110000000000000011111111111111111111111111000000000000000
1111111110000000000000001111111111111111111111111000000000000000
1111111110000000000000000111111111000001111111110000000000000000
1111111111000000000000000000100000000000011111100000000000000000
1111111111000000000000000000000000000000001111100000000000000000
1111111111000000000000000000000000000000001111100000000000000000
1111111111100000000000000000000000000000000111000000000000000000
1111111111100000000000000000000000000000000111100000000000000000
1111111111100000000000000000000000000000000111100000000000000000
1111111111110000000000000000000000000000000111100000000000000000
1111111111110000000000000000000000000000000111100000000000000000
1111111111110000000000000000000000000000000111110000000000000000
1111111111110000000000000000000000000000000111110000000000000000
1111111111100000000000000000000000000000000111110000000000000000
1111111111100000000000000000000000000000000111111000000000000000
1111111111000000000000000000000000000000000111111000000000000000
1111111100000000000000000000000000000000000111111000000000000000
1111111000000000000000000000000000000000000111111100000000000000
1111100000000000000000000000000000000000000111111100000000000000
1111000000000000000000000000000000000000000111111110000000000000
1100000000000000000000000000000000000000000111111111000000000000
1000000000000000000000000000000000000000000111111111100000000001
0000000000000000000000000000000000000000000111111111111100000111
0000000000000000000000000000000000000000000111111111111111111111
0000000000000000000000000000000000000000000111111111111111111111
0000000000000000000000000000000000000000001111111111111111111111
0000000000000000000000000000000000000000001111111111111111111111
0000000000000000000000000000000000000000011111111111111111111111
0000000000000000000000000000000000000000111111111111111111111111
0000000000000000000000000000000000000001111111111111111111111111
0000000000000000000000000000000000000111111111111111111111111111
0000000000000000000000000000000000011111111111111111111111111111
0000000000000000000000000000000000111111111111111111111111111111
1000000000000000000000000000000001111111111111111111111111111111
1110000000000000000000000000000001111111111111111111111111111110
1111100000000000000000000000000001111111111111111111111111111100
1111111000000000000000000000000001111111111111111111111111111000
1111111110000000000000000000000011111111111111111111111111110000
1111111111000000000000000000000011111111111111111111111111100000
1111111111100000000000000000000011111111111111111111111111000000
1111111111100000000000000000000011111111111111111111111110000000
1111111111100000000000000000000011111111111111111111111100000000
1111111111100000000000000000000011111111111111111111111000000000
