111111111111111111111100000000000000000000001111100000000000000011111111111111111111111111111111111111111111111111111111111111110000000
111111111111111111111100000000000000000000111111111000000000000011111111111111111111111100000000000000000011111111111111111111110000000
111111111111111111111100000000000000000001111111111110000000000011111111111111111111111000000000000000000001111111111111111111110000000
111111111111111111111100000000000000000011111111111111000000000011111111111111111111110000000000000000000000111111111111111111110000000
111111111111111111111110000000000000000111111111111111100000000011111111111111111111110000000000000000000000011111111111111111110000000
111111111111111111111110000000000000000111111111111111100000000011111111111111111111110000000000000000000000011111111111111111110000000
111111111111111111111111000000000000001111111111111111110000000011111111111111111111110000000000000000000000011111111111111111100000000
111111111111111111111111100000000000011111111111111111110000000011111111111111111111110000000000000000000000011111111111111111100000000
111111111111111111111111111000000000111111111111111111110000000011111111111111111111100000000000000000000000011111111111111111000000000
111111111111111111111111111110000001111111111111111111110000000011111111111111111111100000000000000000000000011111111111111111000000000
111111111111111111111111111111100011111111111111111111110000000011111111111111111111100000000000000000000000111111111111111110000000000
111111111111111111111111111111111111111111111111111111110000000011111111111111111111100000000000000000000001111111111111111110000000000
111111111111111111111111111111111111111111111111111111110000000011111111111111111111100000000000000000000011111111111111111110000000000
111111111111111111111111111111111111111111111111111111110000000011111111111111111111100000000000000000000011111111111111111100000000000
111111111111111111111111111111111111111111111111111111110000000011111111111111111111110000000000000000000111111111111111111100000000000
111111111111111111111111111111111111111111111111111111100000000011111111111111111111110000000000000000000111111111111111111100000000000
111111111111110011111111111111111111111111111111111111000000000011111111111111111111110000000000000000001111111111111111111000000000000
011111111111000000111111111111111111111111111111111111000000000011111111111111111111110000000000000000001111111111111111111000000000000
011111111100000000001111111111111111111111111111111110000000000011111111111111111111110000000000000000001111111111111111110000000000000
011111111000000000000111111111111111111111111111111000000000000011111111111111111111110000000000000000000111111111111111110000000000000
011111111000000000000011111111111111111111111111110000000000000011111111111111111111110000000000000000000111111111111111100000000000000
011111111000000000000001111111111111111111111111100000000000000011111111111111111111110000000000000000000111111111111111000000000000000
111111111000000000000000111111111111111111111111100000000000000011111111111111111111110000000000000000000011111111111110000000000000000
111111111000000000000000011111111100000111111111000000000000000011111111111111111111110000000000000000000011111111111110000000000111111
111111111100000000000000000010000000000001111110000000000000000011111111111111111111110000000000000000000001111111111100000000011111111
111111111100000000000000000000000000000000111110000000000000000011111111111111111111110000000000000000000001111111111000000000111111111
111111111100000000000000000000000000000000111110000000000000000011111111111111111111110000000000000000000000111111110000000001111111111
111111111110000000000000000000000000000000011100000000000000000011111111111111111111110000000000000000000000111111100000000011111111111
111111111110000000000000000000000000000000011110000000000000000011111111111111111111110000000000000000000000111111000000000111111111111
111111111110000000000000000000000000000000011110000000000000000011111111111111111111110000000000000000000000111111000000001111111111111
111111111111000000000000000000000000000000011110000000000000000011111111111111111111110000000000000000000000111111100000111111111111111
111111111111000000000000000000000000000000011110000000000000000011111111111111111111110000000000000000000001111111110001111111111111111
111111111111000000000000000000000000000000011111000000000000000011111111111111111111110000000000000000000011111111111111111111111111111
111111111111000000000000000000000000000000011111000000000000000011111111111111111111110000000000000000000011111111111111111111111111111
111111111110000000000000000000000000000000011111000000000000000011111111111111111111110000000000000000000111111111111111111111111111111
111111111110000000000000000000000000000000011111100000000000000011111111111111111111110000000000000000001111111111111111111111111111111
111111111100000000000000000000000000000000011111100000000000000011111111111111111111110000000000000000011111111111111111111111111111111
111111110000000000000000000000000000000000011111100000000000000011111111111111111111111000000000000000011111111111111111111111111111110
111111100000000000000000000000000000000000011111110000000000000011111111111111111111111000000000000000111111111111111111111111111111100
111110000000000000000000000000000000000000011111110000000000000011111111111111111111111100000000000001111111111111111111111111111111000
111100000000000000000000000000000000000000011111111000000000000011111111111111111111111100000000000011111111111111111111111111111110000
110000000000000000000000000000000000000000011111111100000000000011111111111111111111111110000000000011111111111111111111111111111100000
100000000000000000000000000000000000000000011111111110000000000111111111111111111111111110000000000111111111111111111111111111111000000
000000000000000000000000000000000000000000011111111111110000011111111111111111111111111110000000001111111111111111111111111111110000000
000000000000000000000000000000000000000000011111111111111111111111111111111111111111111100000000001111111111111111111111111111100000000
000000000000000000000000000000000000000000011111111111111111111111111111111111111111111000000000001111111111111111111111111111000000000
000000000000000000000000000000000000000000111111111111111111111111111111111111111111110000000000001111111111111111111111111111000000000
000000000000000000000000000000000000000000111111111111111111111111111111111111111111000000000000001111111111111111111111111110000000000
000000000000000000000000000000000000000001111111111111111111111111111111111111111100000000000000001111111111111111111111111110000000000
000000000000000000000000000000000000000011111111111111111111111111111111111111110000000000000000000111111111111111111111111110000000000
000000000000000000000000000000000000000111111111111111111111111111111111111111100000000000000000000111111111111111111111111111000000000
000000000000000000000000000000000000011111111111111111111111111111110000111100000000000000000000000011111111111111111111111111000000000
000000000000000000000000000000000001111111111111111111111111111111000000000000000000000000000000000011111111111111111111111111100000000
000000000000000000000000000000000011111111111111111111111111111110000000000000000000000000000000000001111111111111111111111111100000000
100000000000000000000000000000000111111111111111111111111111111100000000000000000000000000000000000000111111111111111111111111110000000
111000000000000000000000000000000111111111111111111111111111111000000000000000000000000000000000000000001111111111111111111111110000000
111110000000000000000000000000000111111111111111111111111111110000000000000000000000000000000000000000000000111111111111111111110000000
111111100000000000000000000000000111111111111111111111111111100000000000000000000000000000000000000000000000000111111111111111110000000
111111111000000000000000000000001111111111111111111111111111000000000000000000000000000000000000000000000000000011111111111111110000000
111111111100000000000000000000001111111111111111111111111110000000000000000000000000000000000000000000000000000001111111111111111000000
111111111110000000000000000000001111111111111111111111111100000000000000000000000000000000000000000000000000000001111111111111111000000
111111111110000000000000000000001111111111111111111111111000000000000000000000000000000000000000000000000000000000111111111111111000000
111111111110000000000000000000001111111111111111111111110000000000000000000000000000000000000000000000000000000000111111111111111000000
111111111110000000000000000000001111111111111111111111100000000000000000000000000000000000000000000000000000000000111111111111111000000
111111111110000000000000000000001111111111111111111111000000000000000000000000000000000000000000000000000000000000011111111111111000000
111111111110000000000000000000001111111111111111111110000000000000000000000000000000000000000000000000000000000000011111111111111000000
111111111110000000000000000000001111111111111111111110000000000000000000000000000000000000011110000000000000000000011111111111111000000
111111111110000000000000000000001111111111111111111100000000000000000000000000000000000000111111000000000000000000011111111111111000000
111111111110000000000000000000001111111111111111111000000000000000000000000000000000000001111111000000000000000000001111111111111000000
111111111110000000000000000000001111111111111111111000000000000000000000000000000000000011111111000000000000000000001111111111111000000
111111111110000000000000000000001111111111111111110000000000000000000000000000000000000111111111100000000000000000001111111111111000000
111111111110000000000000000000001111111111111111110000000000000000000000000000000000000111111111100000000000000000001111111111111000000
111111111110000000000000000000001111111111111111100000000000000000000000000000000000000111111111100000000000000000000111111111111000000
111111111110000000000000000000001111111111111111000000000000000000000000000000000000001111111111100000000000000000000111111111111000000
111111111110000000000000000000011111111111111110000000000000000000000000000000000000001111111111100000000000000000000111111111111000000
111111111110000000000000000000111111111111111100000000000000000000000000000000000000011111111111100000000000000000000111111111111100000
111111111110000000000000000011111111111111111000000000000000000000000000000000000000111111111111100000000000000000000111111111111110000
111111111110000000000001111111111111111111110000000000000000000000000000000000000001111111111111100000000000000000000011111111111111000
111111111111000000001111111111111111111111100000000000000110000000000000000000000011111111111111100000000000000000000011111111111111110
111111111111000000111111111111111111111111000000000001111111111000000000000000001111111111111111100000000000000000000011111111111111111
111111111111100001111111111111111111111110000000000111111111111110000000000000111111111111111111100000000000000000000011111111111111111
111111111111111111111111111111111111111110000000011111111111111111000000000011111111111111111111100000000000000000000011111111111111111
111111111111111111111111111111111111111110000001111111111111111111100000000111111111111111111111100000000000000000000011111111111111111
111111111111111111111111111111111111111110001111111111111111111111110000001111111111111111111111100000000000000000000011111111111111111
111111111111111111111111111111111111111111111111111111111111111111110000001111111111111111111111100000000000000000000011111111111111111
111111111111111111111111111111111111111111111111111111111111111111110000000111111111111111111111100000000000000000000011111111111111111
111111111111111110000000000000000000000011111111111111111111111111100000000011111111111111111111100000000000000000000011111111111111111
111111111111111100000000000000000000000011111111111111111111111111100000000001111111111111111111100000000000000000000011111111111111111
111111111111111000000000000000000000000011111111111111111111111111000000000000111111111111111111100000000000000000000011111111111111111
111111111111111000000000000000000000000001111111111111111111111111000000000000111111111111111111100000000000000000000011111111111111111
